35,50
0,0,0,0,0,0,0,0,0,0,0,0,0,0,0,0,0,0,0,0,0,0,0,0,0,0,0,0,0,0,0,0,0,0,0
0,0,0,0,-,-,+,0,0,0,0,0,0,0,0,0,0,0,0,0,0,0,0,0,0,0,0,+,-,-,-,-,-,-,1
0,0,-,-,-,-,-,0,0,0,0,0,0,0,0,0,0,0,0,0,0,0,0,0,0,0,+,-,-,-,-,-,-,-,1
0,-,-,-,-,-,-,+,0,0,0,0,0,0,0,0,0,0,0,0,0,0,0,0,0,0,-,-,-,-,B1,-,-,-,1
0,-,-,-,-,-,-,-,+,0,0,0,0,0,0,0,0,0,0,0,0,0,0,0,0,0,-,-,-,-,S1,-,-,-,1
0,-,-,-,B1,-,-,-,-,-,+,0,0,0,0,0,0,0,0,0,0,0,0,0,0,+,-,-,-,-,-,-,-,-,1
1,-,-,-,-,S1,-,-,-,-,-,+,0,0,0,0,0,0,0,0,0,0,0,0,+,-,-,-,-,-,-,-,-,-,1
1,-,-,-,-,-,-,-,-,-,-,-,0,0,0,0,0,0,0,0,0,0,0,0,+,-,-,-,-,-,-,-,-,-,1
1,-,-,-,-,-,-,-,-,-,-,-,+,0,0,0,0,0,0,0,+,0,0,+,-,-,-,-,-,-,1,-,-,-,1
1,-,-,-,-,-,-,-,-,-,-,-,-,+,0,0,0,0,0,0,+,-,-,-,-,-,-,-,-,-,-,-,-,1,1
1,-,-,-,-,-,-,-,-,-,-,-,-,-,-,-,+,0,0,+,-,-,-,-,-,1,-,-,-,-,-,-,-,1,1
1,+,-,-,-,-,-,-,1,-,-,-,-,-,-,-,-,-,-,-,-,-,-,-,-,-,-,-,-,-,-,-,-,1,1
0,0,0,0,+,-,-,-,-,-,-,-,-,1,-,-,-,-,-,-,-,-,1,1,-,-,-,-,-,-,-,-,-,1,1
0,0,0,0,0,+,-,-,-,-,-,-,-,-,-,-,-,-,-,-,-,-,-,-,-,-,-,-,-,-,-,-,-,1,1
0,0,0,0,0,0,0,+,-,-,-,-,-,-,-,-,-,-,-,-,-,-,-,-,-,-,-,1,-,-,-,-,-,1,1
0,0,0,0,0,0,0,0,+,-,-,-,-,-,-,-,1,-,-,-,-,-,-,-,-,-,-,-,-,-,-,-,-,1,1
0,0,0,0,0,0,0,0,0,-,-,-,-,-,-,-,-,-,-,-,-,-,-,-,-,-,-,-,-,-,-,-,-,1,1
0,0,0,0,0,0,0,0,0,-,-,-,-,-,-,-,-,-,-,-,-,-,+,0,0,0,+,-,-,-,-,-,-,1,1
0,0,0,0,0,0,0,0,0,+,-,-,-,-,-,-,-,+,0,0,0,0,0,0,0,0,0,+,-,-,-,-,-,1,1
0,0,0,0,0,0,0,0,0,0,-,-,-,-,-,-,-,0,0,0,0,0,0,0,0,0,0,0,-,-,-,-,-,-,1
1,0,0,0,0,0,0,0,0,0,-,-,-,-,-,-,-,0,0,0,0,0,0,0,0,0,0,0,+,-,-,-,-,-,1
1,0,0,0,0,0,0,0,0,+,-,-,1,-,-,-,-,+,0,0,0,0,0,0,0,0,0,0,0,-,-,-,-,-,1
1,0,0,0,0,0,0,0,+,-,-,-,-,-,-,-,-,+,0,0,0,0,0,0,0,0,0,0,0,-,-,-,-,-,1
1,0,0,0,0,0,0,+,-,-,-,-,-,-,-,+,0,0,0,0,0,0,0,0,0,0,0,0,0,-,-,-,-,-,1
1,0,0,0,0,1,+,-,-,-,-,-,-,-,-,0,0,0,0,0,0,0,0,0,0,0,0,0,+,-,-,-,-,-,1
1,0,0,0,0,1,-,-,-,1,-,-,-,-,-,+,0,0,0,0,0,0,0,0,0,0,+,-,-,-,-,-,-,-,1
1,0,0,0,1,+,-,-,-,-,-,-,-,-,-,-,+,0,0,0,0,0,0,0,+,-,-,-,-,-,1,1,-,-,1
1,0,0,1,1,-,-,-,-,-,-,-,-,-,-,-,-,-,-,-,+,0,0,+,-,-,-,-,-,-,1,-,-,-,1
1,1,1,1,+,-,-,-,-,-,-,-,-,-,-,-,-,-,-,-,-,-,-,-,-,-,-,-,-,-,-,-,-,-,1
1,1,1,1,-,-,1,-,-,-,-,-,-,-,-,-,-,1,-,-,-,-,-,-,-,-,-,-,-,-,-,-,-,-,1
1,1,1,+,-,-,1,-,-,-,-,-,-,-,-,-,-,-,-,-,-,-,-,-,-,-,-,1,-,-,-,-,-,-,1
1,1,1,-,-,-,-,-,-,+,1,1,1,1,1,+,-,-,-,-,-,1,-,-,-,-,-,-,-,-,-,-,-,1,1
1,1,1,-,-,-,-,-,+,1,1,1,1,1,1,1,1,+,-,-,-,-,-,-,-,-,-,-,-,-,-,-,-,1,1
1,1,+,-,-,-,-,-,1,1,1,1,1,1,1,1,1,1,+,-,-,-,-,-,-,-,-,-,-,-,-,-,-,1,1
1,+,-,-,-,-,-,-,1,1,1,1,1,1,1,1,1,1,1,-,-,-,-,-,1,-,-,-,-,-,1,-,-,1,1
1,-,-,-,-,-,-,-,1,1,1,1,1,1,1,1,1,1,1,-,-,-,-,-,-,-,-,-,-,-,-,-,-,1,1
1,-,-,-,-,-,-,-,+,1,1,1,1,1,1,1,1,1,+,-,1,-,-,-,-,-,-,-,-,-,S1,B1,-,1,1
1,-,-,-,-,-,-,-,-,-,-,+,1,1,1,1,1,+,-,-,-,-,-,-,-,-,1,-,-,-,-,-,-,1,1
1,-,-,-,1,+,-,-,-,-,-,-,+,1,1,1,+,-,-,-,-,-,-,-,-,-,-,-,-,-,-,-,1,1,1
1,-,-,-,1,1,-,-,-,-,-,-,+,1,1,1,+,-,-,-,-,-,-,1,-,-,-,-,-,-,-,-,1,1,1
1,-,-,-,+,1,-,-,-,-,-,-,1,1,1,1,1,+,-,-,-,-,-,-,-,-,-,-,-,-,-,+,1,1,1
1,-,-,-,-,-,-,-,-,-,-,-,1,1,1,1,1,1,-,-,-,-,-,-,-,-,-,-,+,1,1,1,1,1,1
1,-,-,-,-,-,-,-,-,-,-,-,+,1,1,1,1,1,-,-,-,-,-,-,-,-,-,-,1,1,1,1,1,1,1
1,-,-,-,-,-,-,-,-,-,-,-,-,1,1,1,1,+,-,-,-,1,-,-,-,-,-,+,1,1,1,1,1,1,1
1,-,-,-,-,-,-,-,1,-,-,-,-,-,-,-,-,-,-,-,-,-,-,-,-,-,+,1,1,1,1,1,1,1,1
1,-,-,S0,-,-,-,-,-,-,-,-,-,-,-,-,-,-,-,-,-,-,-,-,+,1,1,1,1,1,1,1,1,1,1
1,-,-,B0,-,-,-,-,-,-,-,-,-,-,-,-,-,-,-,-,-,-,-,+,1,1,1,1,1,1,1,1,1,1,1
1,-,-,-,-,-,-,-,-,-,-,-,-,-,-,-,-,-,-,-,-,-,-,+,1,1,1,1,1,1,1,1,1,1,1
1,-,-,-,-,-,-,-,-,-,-,-,-,-,-,-,-,-,-,-,-,-,+,1,1,1,1,1,1,1,1,1,1,1,1
1,1,1,1,1,1,1,1,1,1,1,1,1,1,1,1,1,1,1,1,1,1,1,1,1,1,1,1,1,1,1,1,1,1,1